1 10 10
##########
 p   1 2 #
######## #
#      # #
# #### #k#
# # x# # #
# #    # #
# ###### #
#m       #
##########