6 13 31
###############################
#p * *b   W   *  ** * *  1 1 *#
# # # # #*# #k#*# # # # # #*# #
#    * * *** ** k k  * 1  **  #
# #*# # # #F#5# #b#1# # # # #*#
#  D   2   * * * **  d d * 1**#
# # #*# # # #B# #*#*#*#*# #2# #
#   *   2   * * * *x* *d F  dd#
# # # # #*# # # # #d# #*# #*# #
# W ****       2 *2  b 1 1    #
# # # # # # # # # #*# # # # #*#
#  ** *   *    d   1dd  1     #
###############################