7 13 31
###############################
#p  *    mmmm                 #
# D *                         #
#  F*         1111111         #
# b *        2222222          #
#b  *        11111111         #
# b *         mmmmmmmmm       #
#f  *          dddddddd       #
# s *                         #
#  f*            1111111      #
#  **   dddddddd              #
#    *                        #
###############################