8 13 31
###############################
#p    b   *    *   *  * * *   #
# # # #*# # #*#*# # # #*#*#*# #
#  n*  F  ***  *  m k *m  m **#
# # # # # #*# # #*#*# # # # #*#
#f  b b  F x **  *k * k  k m  #
# # # # # # # # # #*# #*# # # #
#* W* s  F *  * k k  *  kmmm  #
# # # # #*# # # #*#*# # # # # #
#* W  **  *  W   *  k  k  mmm #
# #*# # # # # # #*#k# # # # # #
#    F   F  *   *  *  k m m m #
###############################
